1.06825 12.0445
8
	StaticRect
		2 15 4 17 255 255 255 255

	StaticRect
		28 -1 30 19 255 255 255 255

	TriggerLevelchange
		28 13 26 11 0 255 0 127

	StaticRect
		19 13 28 17 255 255 255 255

	StaticRect
		2 17 -4 13 255 255 255 255

	StaticRect
		-4 19 -6 -1 255 255 255 255

	StaticRect
		-4 -1 28 1 255 255 255 255

	StaticRect
		-4 17 28 19 255 255 255 255

