0 4.89302
18
	TriggerKill
		3 18 9 20 255 0 0 255

	StaticRect
		11 14 13 10 255 255 255 255

	TriggerKill
		13 10 11 8 255 0 0 255

	TriggerKill
		15 18 21 20 255 0 0 255

	TriggerKill
		10 2 14 3 255 0 0 255

	TriggerLevelchange
		25 6 24 2 0 255 0 127

	StaticRect
		1 14 3 20 255 255 255 255

	StaticRect
		21 20 23 14 255 255 255 255

	StaticRect
		9 20 15 14 255 255 255 255

	StaticRect
		7 5 5 10 255 255 255 255

	StaticRect
		5 5 10 2 255 255 255 255

	StaticRect
		14 2 19 5 255 255 255 255

	StaticRect
		19 5 17 10 255 255 255 255

	StaticRect
		-1 2 25 0 255 255 255 255

	StaticRect
		25 6 23 20 255 255 255 255

	StaticRect
		-1 6 1 20 255 255 255 255

	StaticRect
		-1 20 -3 0 255 255 255 255

	StaticRect
		25 0 27 20 255 255 255 255

