0 0.08079
16
	TriggerKill
		1 1 3 -5 255 0 0 255

	StaticRect
		-3 1 7 3 255 255 255 255

	StaticRect
		-3 1 -7 -3 255 255 255 255

	StaticRect
		7 1 11 -3 255 255 255 255

	StaticRect
		-7 -3 -9 -9 255 255 255 255

	TriggerLevelchange
		3 1 5 -1 0 255 0 127

	StaticRect
		-1 -7 -3 -9 255 255 255 255

	StaticRect
		5 -7 7 -9 255 255 255 255

	TriggerKill
		11 -3 13 -9 255 0 0 255

	TriggerKill
		11 -9 9 -13 255 0 0 255

	TriggerKill
		-7 -9 -5 -13 255 0 0 255

	TriggerKill
		5 -5 -1 -11 255 0 0 255

	TriggerKill
		1 -11 3 -13 255 0 0 255

	StaticRect
		-5 -13 -3 -17 255 255 255 255

	StaticRect
		9 -13 7 -17 255 255 255 255

	StaticRect
		9 -17 -5 -19 255 255 255 255

