4
-11.84 -8.75 0
15.62 -8.65 1
15.95 6.96 2
-12.07 6.76 3
12
	StaticRect
		-13 -12 17 -10 255 255 255 255

	StaticRect
		17 -12 19 10 255 255 255 255

	StaticRect
		17 10 -13 8 255 255 255 255

	StaticRect
		-13 -12 -15 10 255 255 255 255

	StaticRect
		17 -1 13 -3 255 255 255 255

	StaticRect
		3 -10 5 -2 255 255 255 255

	StaticRect
		15 3 9 5 255 255 255 255

	StaticRect
		-0 8 -2 4 255 255 255 255

	StaticRect
		3 1 5 6 255 255 255 255

	StaticRect
		-13 -3 -4 -1 255 255 255 255

	StaticRect
		-3 -10 -2 -6 255 255 255 255

	StaticRect
		-1 -3 1 -2 255 255 255 255

